M100 50
x-x---------x-x--x-----x-x----x-xx-----x---x-x--x-
---xx--x-x--xx------x-----x-----x--x--xxx-x---x--x
-xx--x-----x-x-----x----------xxx---x------x-x--xx
x-x-------x--xxx---x-xx-x-x--xxx--xxx--x----xx-x-x
---x-xf-x-xxx----x-xxx-xxx-x---x--x-xx-x-xx-x-----
---x----xx-x----xx--x----xx--x-x-x-----x-x----xx-x
x-x----xxxxx------x--xx---------x---x--x--x-xx--x-
--------x-xx-x--x---xx--x-x-x---x--xx-x--x-xxx-x-x
----xx--x-----x---------------xx----x--xx-x---x-xx
-x--x-----------x-xx--x-x--xx--x-x------xxx--xxxx-
-x-xx---x-x---xx--x-x---x--x-x-x--x--xx---xx-x-xxx
x----x----x-x----xx--x-x--x-xx---x-----x----------
--x-------x--------x-----x-------x--x----x-x----x-
xx-xxx----x--xx-----xx--xxx--------x--x-xx------x-
xxx-x---x--x-x------xx--x--x---xx-x--------xx----x
x----x-xxx------------xx-----xx----x-xx-x----xx---
-x-xx-x-x-xxx----x---x---------x-----x--------x-xx
xx-x-x---x--x----x--x---xx-xx---xx---x-x---x---x--
-----------x-------x------xx--xxx--x-xx------x-x--
-x--x-x---------xx--xx---x--x------xxx-xx-x--x--x-
-x--xx--x------x----xxx-xxx---xxxx--x---xx----x---
xx--x---x-x-----x------------------xx---x-------x-
--xx--x-x--------x--------x-x-x--xx----x----------
---xx--x--x--x-x-x--xx-xx--x--x-xx-x-x------x-x-xx
----xx--------x---x-x-x---x-----x----x---x-----x-x
---xx-----xx--------x-x----xx-x----xxx-x--xx---xx-
--x--xx--x--xx-x-----x--x---x--xx-xx---xx--x-x-x--
---x-xx-x-------xxx---x-----xx-x------xx----x-xx-x
----x-----x-------x-xx--x------xx-x----xxxx--x----
x---xx-x--xx---x--x-x-x------------x-----------x-x
-----xx-----x-x---x-----x------x-----x-x---x--x---
--xx--x--x---x-----x-x-xx-xx-----x-x-x-x-x-x------
--x--x--x-xx----------xx-xxx---x-x-x---x-----xx---
----xx-----------x-----------xx--x---x---xx-x-x-xx
------x---x--xx------xx--------x--------xxxxx-x---
--x--x--x---------x-x---x--------xx--xx-----xxxx-x
--------x-x-x-x-x---xx----xxx-x---x----x--xxx-----
------------x-xx----x--xxxxxx-x-x-----x--x-x---x--
--x-xxx---x-xxx-x-xx-xx--x----------x--------x-x--
-xxxx-xxx-x-x---xx-x------xx--xx----xx--x-x-----x-
--x---x---x--xx-----x--x-xx----x-----x--xx------x-
x--x-o------x-x-x---x---x-xx-----------x---x--xx--
x---x--xxxxx-----x-----x-x---x--x---------------xx
x-----x-x-xxx-xx--x-x-x----x-x-x---xx--x--x---x-x-
----xx----x-x-x---x-x---x-x----x-x----x--------x--
-xx----x-------x-----x--xxx----xxxx---x-xx---x-xxx
x-x-xx----xx-x-xx-x-x-----x-x--x-xx-xx-xx------x-x
---xx--x-xx------x-x-x--x-x-xx-----x--x-xxx-xx----
xx--xx-xx---x------x------x-----------xx----------
-x-xx-x----xx---xx-----------x-xxxx-xx----x---xxxx
xx-xx--x---xx-x--x------x--x-x---------x-----x---x
x--xx----x---x--x-------x-x-xx---x------------x--x
x--x---xxxx--xx----xxx-xxxx-x----x-x--x---xxx-x--x
x-x---x-x-x-x-xx---xx----x-x---xx-----xx----x-xxxx
-xx--x-x-------xx-----x--x---x--x-xx--x--xx--xx-x-
xx-x--x----xxx----x--xx----x--x----x-x---x---x----
--x----xx-x-------x------x-x--xxx---xxx------x--x-
-----x----x----xx-------xx---x-x--x----x--x---x--x
xx--xxx--xx---x---xx-x-xxxx-x------xx-x-x-xx-x-xx-
--xxxxx---xxx--x------xx--x---x-xxx--xx----x-x----
--xxx-x-x--xxx--xx---x-xx-xxxx--xx-xx-x-xx-x-xx--x
-x--xx-------x-x----xxx------xx--xx--xx-x-x--x-xxx
-x--xxx-x-x------x--x----x-xx---x-xx----xx----x---
--x---x--xx---xxxx-x---xx--x--------x-----xxx-x---
---xx--x-x------x------x---x-xx--------------x---x
--x---x-xxx----xx-------xxx---x------x-x-x-xx----x
x-xx-x---xx---x---xx--xx-----x----------x-xx-x----
x---------x--xx-xxx---x----xx-x-x--x--x-x---x---xx
---x---x-----xx--x--xxx-----x-x-xxxx------xx-x----
x----------xx----x-xxx------xx--xxxx---xxx-----xx-
xx------x-x-x-x---x--x---xx-------------xxx------x
x----x-xxx-----xx-x--x-xx----------x-xx---xxx---x-
-xx--x-----x----xx-----xx-x-x---xxx-x-x--x----x-x-
---x-------x-------x----------xx-----xx--xx-----xx
xxx-x-x---x--x---x-------x-x-x------xx--xxxxx--xxx
xx-xx---xxx--------xx----x---x---x-----xx-----xx--
------xxx----x---x-------------------x-x-x-x--x---
x-x-x-x-----x---xx---xx--------xxx-x-------x----x-
------x---x-xx-xxx----x----xx-------x-x-----------
x-x-x-------x--xx-----xx--x-x-xxxx-xx-x------x-xx-
----------x--xxxxx--x-xx---xxx--xx-x--xx------x---
xx---xx-x-x--x--xxxxxx---x-x-x-x--x--x--x---x----x
x---x--x--xx-x------x-----x-x-x-x---x-xxx-x---xxx-
--x-x---x---xx--x--xx-----xxxx--xx-x-xxx-xxx-x-x--
--x--x-x-xx-xx---xxxxx----xx-x--x-xxx--x---------x
--xxxx-xxx-x-x-x-xx---x--xxx---------x-x-x-x------
------x----xx--x--x-----x-------x--x---x---x------
-x--x-x--x-x-xxx--xx-xx-x-xx-x-x-x---xxx-x-x----x-
-----x-------xxx----xx--x----x-----xx--xxx-xx----x
xx-----xx--x---xx-xx----xx--x--xxx-x-------x-----x
----x---xx----x--x-----x---x----------x---x---xxx-
----xx----x-x---x--x--x-------x-----xx-x---x--x-x-
-x--x---x-----xxx-x-x-x-----x-x----x--x--x-----x--
x---x-x--------xxxx----x---xx----xx---x--xx------x
------x-x----xx--------x--x--x--x-x---x--x-x------
-----xx-x--x-x--------x--x--------xx--x-x-x--x----
-x--xx--xx-----xxx-x------x-x------x----x-x-x-----
x----xx--x--xxxxx-------x-x-x------x-xxxx-xx-x-x-x
--x---x---xx----x-xx-x--xx---x----x-x--x---x--x--x
xxxx----xxxxx-----x--x------x-x-x--x-x-xxx-xx----x
