M50 50
x---x---x-------------xxx-x--xx----------x-x------
-xxx-----------x---x---x----x-xx-xxx------x-xx-xx-
-x--xxxx----x-------xx-x-------x--x---x----x-xx-x-
-xx---x----------------x------------x----x--x-xx--
--x------xx---xxx-----xxxx--x-x----x-x----x------x
--x--xx--x-----xx--xx---xx----x---xx--x---x--x----
-----x---x-xxx-x---xxx-x--------x-xxxx----x-x--x--
-x-----xx----xx-x-------------xxxx--x---xx--x--x--
-------xx--xx--x--xxx-----x-x-----x--x-x-x-x------
---xx-x--x-x--------x-x----x-x----x---x-----xx----
-xx-----x----x-xx----------xx-xxx----xx-------x-x-
xx-xx-----x---xxx-x--xx--x--x--x--x---x-x---x---x-
--------xx---xx---x------x-x---x--x----x--x-------
--xxx--xx--x-x--x---x-x-xxx------x-----x--x--x----
-xx--x-x-x--xxxxx--xx-x--xx---x-x----xx-----xx-x--
---x-x---x-----x---x----xx--xx-x-x--xxx-xx-xx---xx
-xx-----x----x----xx---x-x-----xx-x-x--------xx-x-
--x-----xx-xxxxxx------xx-x-x---x---x-x-xx--x--x-x
---x------------x------x----x-----x-x--x----------
--x-x---x--xx---x----x----x----x-xx-x--x-x-x--xx--
-xxx-----x--x---xx-xx--x--xx--x---x---x--x--------
---xx----x---x---x---x---xxx--x-x-x-xx-xx--xx-xx--
------x-xx-----xx--x---x--------x-x----xxx---x----
---x---xxx-x---xx--x---x------x-x--x-----x-x--x-x-
-xxx--------xxx-------x-x-xx------xx-x---x-------x
-x--x-xxx-xx---x-xxxx---x-x---x--xxx---xx--xx-xx-x
---------xx--x-xxxx---x--x--x----xx-xxxx-------x--
-xx--x--x-xx---o-x--x---x--x---x-x----x--xx-xx-xx-
----x--x--x-xxx-----x--------x-----x----xx--x-----
----xx---------x---xx-----x--x---x-----x--x--x--x-
----x----x-x--x-xx-x--xxx-------x-----x--x-x---x--
--xx---------x--xxxxx--x-----x-----x-x--x-x-xxx---
--xx-xx--x-x-xxx---xx-x--------x----xx-------x-x--
---x-xxxx-xxx-x-----x--x--x-x-xx-x---x----xx--x-xx
x-x---xxx--xx-xx-x-x-xxxx--x---x--xx----xx--xx----
xx-x-x----x---xx----xx----xx------x-x--xx-----xxx-
xx-----xxxx--xx-xx-xxx---x-x---x-x-xxx---x---x---x
-xx-x----x-x-xx--------x-x-xx--------x---x-x-x-x--
x-xx-x------x-xxx-x--xx--x-xx--x-----xx-x--xxxxx--
-x------x-----x-xx-x--x-x--x--xxx-x-x-xx-x-xx-----
-----x--x---xx---x-x------x-xx--x--x--x-----x-x-x-
---xx-xx------------------x---xx--x------xf-xxxx--
-----xx-x---x--x-----x---xxxxx-xx-x---xx-------xxx
x-xx---x--x----x---x-x-x---xx-x-x-x-xx-x-x---x----
x----x----x--xx----x-x----xx----x------x---xxx--x-
x-x--xx-x------x------xx-x---x-x-x--x---x-x---x---
----x---x----xx-x--xxxxxxxx-x---x-x--x-x----------
x---xxxx-xx-x----x--x------x-x-x----x--x-------x-x
----x-x----x--x-xx---x-------xx----x-x--xxxx------
x-----x----------xxx------xx-x-x--xx--x-x---x-x-xx
